11111111111111111111111111111111111
10000000000000000000000000000000001
10000000000000000000000000000000001
1000V0000000000000000000000000VV0V1
100011110000111100111111111111VE001
100011110000111100111111111111VV0V1
10001111000011110011110000111100001
10001111000011110011110000111100001
10001111111111110000000011110000001
1000111111111111000000111100000P001
1000000000V011110000111100000000001
100C00000V0011110011110000111100001
10000C00V00011110011111111111100001
10000C000V0011110011111111111100001
10000V00VVV00000V00000000000000V001
100000V00V00V0000000000000000000001
1000000V000V00000000000000000000001
11111111111111111111111111111111111
