1111111111111111111111111111111
1P00000000000000001000000000001
1V0V111001001001111001111111001
1V00V0100100100V000000000001001
1VV00V1111111111001001111001111
1000001000000001001001000000001
1001111111001111001111111001111
1000000000001001000001000000001
10V0V0V0V1001001001111001111001
1000000V01V000V1000001001000001
1V0V0V0V0100V001111001111111001
100100100000V001000000001000001
100100100VVVVV0V001111111001001
100100100V001000001000001001001
100100100V111111VVVVV1111111001
1C00000000000000000001000000001
1111111001001111111111111111111
100000000100V000V000VV000000001
10011111110000V00V0V000V000V111
1000000000001V0000000V0000000E1
1111111111111111111111111111111