1111111111111111111111111111111
1P00000000000000001000000000001
1101111001001001111001111111001
1100101001001001000000000001001
1110011111111111001001111001111
1000001000000001001001000000001
1001111111001111001111111001111
1000000000001001000001000000001
1010101011001001001111001111001
1000000101100011000001001000001
1101010101001001111001111111001
1001001000001001000000001000001
1001001001111101001111111001001
1001001001001000001000001001001
1001001001111111111111111111001
1C00000000000000000001000000001
1111111001001111111111111111111
1000000001001000100011000000001
1001111111000010010100010001111
10000000000011000000010000000E1
1111111111111111111111111111111