11111111
1P000111
10000111
1C0C0001
1000E001
11111111