11111111111111111111111111111111111111111111111111111111111111111111111111111111111111111111111111111111111111111111
10000000000000000000000000000000001111111111110000000000000110000000000000000000000000000000000000000000000000000001
10000000000000000000000000000000001111111111110000000000000PC0000000000000000000000000000000000000000000000000000001
1000000000000000000000000000000000111111111111000000000000000E000000000000000000000000000000000000000000000000000001
10000000000000000000000000000000000000000000000000000000000000001100000000000000000000000000000000000000000000000001
10000000000000000000000000000000000000000000000000000000000000001100000000000000000000000000000000000000000000000001
10000000000000000000000000000000000110000000000000000000000000001100000000000000000000000000000000000000000000000001
10000000000000000000000000000000000110000000000000000000000000001100000000000000000000000000000000000000000000000001
10000000000000000000000000000000000110000000000000000000000000001100000000000000000000000000000000000000000000000001
10000000000000000000000000000000000110000000000000000000000000001100000000000000000000000000000000000000000000000001
10000000000000000000000000000000000111111100000000000000000000001100000000000000000000000000000000000000000000000001
10000000000000000000000000000000000111111100000000000000000000001100000000000000000000000000000000000000000000000001
1000000000000000000000000000000000000000C100000000000000000000001100000000000000000000000000000000000000000000000001
10000000000000000000000000000000000111111C00000000000000000000001100000000000000000000000000000000000000000000000001
10000000000000000000000000000000000111111100000000000000000000001100000000000000000000000000000000000000000000000001
10000000000000000000000000000000000000000000000000000000000000001100000000000000000000000000000000000000000000000001
10000000000000000000000000000000000000000000000000000000000000001100000000000000000000000000000000000000000000000001
10000000000000000000000000000000000000000000000000000000000000001100000000000000000000000000000000000000000000000001
10000000000000000000000000000000000000000000000000000000000000001100000000000000000000000000000000000000000000000001
10000000000000000000000000000000000000000000000000000000000000001100000000000000000000000000000000000000000000000001
10000000000000000000000000000000000000000000000000000000000000001100000000000000000000000000000000000000000000000001
10000000000000000000000000000000000000000000000000000000000000001100000000000000000000000000000000000000000000000001
10000000000000000000000000000000000000000000000000000000000000001100000000000000000000000000000000000000000000000001
10000000000000000000000000000000000000000000000000000000000000001100000000000000000000000000000000000000000000000001
10000000000000000000000000000000000000000000000000000000000000001100000000000000000000000000000000000000000000000001
10000000000000000000000000000000000000000000000000000000000000001100000000000000000000000000000000000000000000000001
10000000000000000000000000000000000000000000000000000000000000001100000000000000000000000000000000000000000000000001
10000000000000000000000000000000000000000000000000000000000000001100000000000000000000000000000000000000000000000001
10000000000000000000000000000000000000000000000000000000000000001100000000000000000000000000000000000000000000000001
10000000000000000000000000000000000000000000000000000000000000001100000000000000000000000000000000000000000000000001
10000000000000000000000000000000000000000000000000000000000000001100000000000000000000000000000000000000000000000001
10000000000000000000000000000000000000000000000000000000000000001100000000000000000000000000000000000000000000000001
10000000000000000000000000000000000000000000000000000000000000001100000000000000000000000000000000000000000000000001
10000000000000000000000000000000000000000000000000000000000000001100000000000000000000000000000000000000000000000001
10000000000000000000000000000000000000000000000000000000000000001100000000000000000000000000000000000000000000000001
10000000000000000000000000000000000000000000000000000000000000001100000000000000000000000000000000000000000000000001
10000000000000000000000000000000000000000000000000000000000000001100000000000000000000000000000000000000000000000001
10000000000000000000000000000000000000000000000000000000000000001100000000000000000000000000000000000000000000000001
10000000000000000000000000000000000000000000000000000000000000001100000000000000000000000000000000000000000000000001
10000000000000000000000000000000000000000000000000000000000000001100000000000000000000000000000000000000000000000001
10000000000000000000000000000000000000000000000000000000000000001100000000000000000000000000000000000000000000000001
10000000000000000000000000000000000000000000000000000000000000001100000000000000000000000000000000000000000000000001
10000000000000000000000000000000000000000000000000000000000000001100000000000000000000000000000000000000000000000001
10000000000000000000000000000000000000000000000000000000000000001100000000000000000000000000000000000000000000000001
10000000000000000000000000000000000000000000000000000000000000001100000000000000000000000000000000000000000000000001
10000000000000000000000000000000000000000000000000000000000000001100000000000000000000000000000000000000000000000001
10000000000000000000000000000000000000000000000000000000000000001100000000000000000000000000000000000000000000000001
10000000000000000000000000000000000000000000000000000000000000001100000000000000000000000000000000000000000000000001
10000000000000000000000000000000000000000000000000000000000000001100000000000000000000000000000000000000000000000001
10000000000000000000000000000000000000000000000000000000000000001100000000000000000000000000000000000000000000000001
10000000000000000000000000000000000000000000000000000000000000001100000000000000000000000000000000000000000000000001
10000000000000000000000000000000000000000000000000000000000000001100000000000000000000000000000000000000000000000001
10000000000000000000000000000000000000000000000000000000000000001100000000000000000000000000000000000000000000000001
10000000000000000000000000000000000000000000000000000000000000001100000000000000000000000000000000000000000000000001
10000000000000000000000000000000000000000000000000000000000000001100000000000000000000000000000000000000000000000001
10000000000000000000000000000000000000000000000000000000000000001100000000000000000000000000000000000000000000000001
10000000000000000000000000000000001111111111110000000000000000000011000000000000000000000000000000000000000000000001
11111111111111111111111111111111111111111111111111111111111111111111111111111111111111111111111111111111111111111111
