1111111111111111111111111111111
10000000010000000C10010000000P1
100111100100111111100100VVVV001
100100000000100000000100VVV1001
111111100111100111100100V111111
1001001000000000001000000000001
100100111111111111111000V00V001
10000010000010000000010VVVVV001
1001111111001001001V01001111V01
1000001000000000001V00001000001
1001001111001111001111001001111
1001000001000001001001001001001
1101111001001111001001111001001
1001000001001000001000000001001
100111100111111100100100111V001
1001000001000000001001V00000001
1001111001001111111111V01111111
1000001000000001001001VV0001001
1111001111111111001001001001001
100000000000E000000000001000001
1111111111111111111111111111111