11111111111111111111111111111111111111111111111111111111111111111111111111111111111111111111
10001111111111111111111111111111111111111111111111111111111111111111111111111111111111111111
100000000000000010010000000010010000010000000000010010010010000000P1000001000000001000000001
11001111111001001001111001111001001001001111111111001001001001111001111001001001111111001001
11000001001001000001000000001000001000000000000000001000000001000001001000001000000000001001
11111111001001111001001111001111111111001111001111001111001001111111001111001001111111111111
11000000000001000000001001000001000000001001000001000001001001000001000000001001000001000001
11001001111001111001111001111001111001001001001111111111001111001111001111111001111001001111
110010010000010000010000010000010000010001000000000000000000000000C1000001000000000000000001
11111001111111111001111001001111111111111001111111111001001111111111001111001001111111111001
11000000000000001000001001000001001000000001001001000001001001001000000001001000000001001001
11001111111111111001001001111111001001001001001001001001111001001111111111111111001001001111
11000001001001000001001001000000001001001001000000001000001001001000000000001001001000000001
11001111001001111001111001111001111001111001001001111001111001001001111111001001111111111001
11001000001001000000001001001001000001001001001001000000001000000000001000000000000000001001
11001001111001111111111001001001111001001111001111111111001111001111001111111111111001111001
11000000001001000001000000001001000000001000000001000000000000001000000001000000000000001001
11001111111001111001001111001001111001111111111001111001001001001111111001111001111001001001
11000000001000000001001000001000000001000000000000001001001001001001000000001001001001000001
11001001111111111001111111001001111111111111111001111111111001111001111111001111001111001111
11001000000000001000001000000001000000000001001000001000000000000001000000001000001001001001
11111111001111001001111001001001111001111111001001111001001111111111001001111001111001111001
11000000000001000001000001001001000001001001000000001001000000001000001000000000000001000001
11111001111111001111001111001111001111001001111111001111111111111111111001001111111001001001
11000000000001000001001001001000000001000001001000001001001000001000000001001000000000001001
11111111001001111111001001111111001001001111001111111001001001001111111111111111111001001111
11001001001000001001000000001000001000001001000001000001001001000001000000001001000001000001
11001001001111111001001111111111V01111001001001111001111001001111001111001111001001001111001
11000000000000000000000000000000001000000000000001001000000000001000000001000000001001000001
11001001111001111111001111111111001111111001001111001001111001111111001111111001001111111111
11001000001001000001001000E000000V1000000001001000000001000001000001000000001001000000000001
11001001111001001111111111001001111111001111111111111111001001001001001111001111111111111001
11001000001000000000000001001000001000000001001000000001001001001000001001000000001000001001
11111001001111001001111001001001111111111111001111001111111001001001001001001111001001111111
11000001001000001001000001001000C00001001000000000001001001001001001001000000001000000001001
11001111111111001001111111111111001111001001001111001001001111111001001111001001111111111001
11000000000001001001001000000001001000001001001001000001000001000001000001001000001001000001
11001001111111001111001111001111111111001001111001001001001111111111001001111111111001001111
11001001000000000000000001000001000000000000001000001000001000001000001001000000001000000001
11111111111001111001111001001111111001111111111111001111001001001001001001001111111111001001
11001000000000001000001001000001000001000000001000001001000001001001001001000001000000001001
11001001111001111111001111111001111001001111111111111001001001001111001111001111001001001001
11001001000000000001001000000000001000000001000000001000001001001001001000001000001001001001
11001001111001111001111001111111001001001111001001111111111001111001001111001111001001111001
11000001000000001001001001001001000001000000001000000001001001001000001000000000001001000001
11001111001111001111001001001001111111001111111111001111001001001111001111111111001111111111
11001000001000000000000000001000C00000001000001000000001000000001000001000000000000000000001
11001111001111001001111111111111001111111001111111001111001001111111001111111001111001001111
11001000001001001000000000000001000001000001001000001000001001001000001001000000001001001001
11001111001001001111111111111111001111001111001111111111001001001001001001111111001111111001
11001000001000000000001001001001001000000000000000000000001000000001000000000000000000001001
11111001111111111001111001001001111001001001111001111111001111001111111001111111111111001001
11001001000001000000000001000000001001001000001000001000000001000001001000001000001000000001
11001001001001001111111111111001111001111001001001111111111001111001001111111001001001001001
11000001001001000000001001000001001001000001001001000001000000001000001000000001001001001001
11111111111001001111001001001111001111001111111001111001001111111001001111111001111001001001
11000001000000001000001000000000001000001000001000001001000000001001000000001001000001001001
11001111001111001111001001111001111111111001001111001001111001111111111111111001111111111001
11000000001000001001000001000001000001001001001000000001000000001001000000000001000000000001
11001111111001111001001111111001111001001001111111001111111001001001001001111001111111001111
11000000001001000000000001000000000000000000001000000001000001000000001000001001000000000001
11111111111111111111111111111111111111111111111111111111111111111111111111111111111111111001
11111111111111111111111111111111111111111111111111111111111111111111111111111111111111111111