111111111111111
1P00C0000E11111
111111111111111
1111-1111111111
111111111111111
111111111111111
111111111111111
111111111111111
111111111111111
