111111111111111111111111111111111111111111111111111111111111111111111111111111111111111111111111111111111111111111111111111
1P0011111111111111111111111111111111111111111111111111111111111111111111111111111111111111111111111111111111111111111111111
10001VVVVV1VVV000000001000000000000001000001000001001000001000000001000000000001001001000000000000VVVVV0V000VVVVV000V00C011
11001VV1111001001111001111001111001111001001111001001111001001111001111111001111001001001111001111VVVVV0V0V0VVVVV0V0V0VVV11
110000000000000000010000010010000000010010000000010010010000010010010000010010000000000010000010010000V000V0000000V00000011
1100111111100100111100111111111100100100100100100100100100111100100100100100111100111100111111100100100100VVVVVVVV110011111
110010010000010010000000010010000010010010010010000000000010000000010010000000000010000000000000010010000010010000010010011
111010011110011110011111110011111110011111110011111110010011111110011111110011111111111111111110010011110010010011111110011
110000000010010000010000000010000000000010010010010010010010000010000010000000010010000000010000010010000010000000010000011
110011110010011110011111110011111111110010010010010011110010010011111110011111110010011111111111110011110010010011110010011
110000010000000010000010000010000000000010000010000010000010010000010010000000010010000010010010000010000000010000000010011
110V1101111111111111001111001111001001111001001001001001111111001001001111111001001001111001001111001111001001111111001V011
11000000001000001000001000001000001001000001001001001000000000001001000000001000001001000000000001001000001001001001001V011
11001VV10V10011110010010011110V1001001001001111111001001111001001111111111001111001001001111111111111001001001001001001V011
110010000000000010010010010000010010010010000000010000000010010000000010010000010010000010000000010000010010000010000000011
111111110011111110010010011111110011110010011110011111111111110011111110010011111110011111111110011110011111110010010010011
110000000000010000010000010000000000010010010000000010010010000010010000000000010000000010000000010000010000000010010010011
11111111001001111111001111111001111001001111111001111001001111001001111001001111001001111111111001001001111111001111111V011
11000001001000001000000000000000001000000000001000001000001000000000000001001001001000000001001000001001001001000001000V011
110011110V1111111001111111111001001111111111111111111001111001111001001111111001111111111001001001111111001001111111111V011
110000010000000000000000010000V10010000000010010000000000010000010010000000000010000010000000000010010000010000010000000011
1100110000111100100111111110V1111111111110010010011110010010011110011111111110011110010010011110010011110010010011110010V11
110010010000010010000010000010000010010000000000000010010010010010000000010010000010000010010010000010000000010000010010V11
110010000110010010010011110011110010011110011110011110010011110010010011110011110011111110010011110010011111111110010010011
1100100V0010010010010010000010000000010010000010000000000000000000010000000010000000010000000000010010000000000010010010011
110010000111111110010010011111110011110010010010V0V0V0V0V0V0V10011110010011110010011110011111110010011111110010011111110011
110000000000010000010000000000000000000010010000000V000V0000010010010010010000010000010000000010010000010000010010000000011
1111100111111111100100111100111100111111111111100V00V0V0V0VV010010011111110010011111110010011111110011110010011111110010011
11000000000000001001001000000001001001001000001000000V000000000000010010010010000000010010010000000000010010010010010010011
110011110011111111110011111111111110010010011110V0V0V0V0V000010011110010011111110010010011111111111110010010010010011110011
11000001000001001000000000000000000001000001000000000000000V000010010000010000000C10000010000000000000000010000010000000011
110011110010010011110010010011110010011110010010000000000000010010011110010000111110011110011111111110011111111111111110011
110010000010010000000010010010000010010010000010000000000000010000000010010010C10000010000000000010000010000000000010010011
110011110011110010011111111111110010010010011110000000000000010011111110010010010010011111110010011110011110011111110010011
110000010000010010010000000000000010010000010010000010000000010010000010010010010010010010010010010000000010000000000010011
110011110011110010010011111111111111110010010010011111110011110010010010010011111111110010010010011111110010010011110010011
110010010000010010010010010000000000000010000000000010000000010000010010000000000010010010000010010010010010010010000000011
110010011110011111111110010011111111111111110011110010011110011110011111110011110010010010010010010010011110011111111111111
110010000010000000010000010000010000000000010010000010000010000010010010000010000010000000010010000010000000010000000000011
110010011110010011111110010011110011110011110010010011110010011111110011111111110011111110011110010011110010011111110010011
110000000010010010000000000010000000010000000010010010010010000000010010000000000010000000000010010010010010000010000010011
110010010011110011111110011111110011110011110011111110010011110010010010011111111111110010011111111110010011110010011110011
110010010000010010000000010000010010000010000010000000000010000010000010000010000010010010000010010000010000010010010010011
110011111111110010010011111110011110011110011111110011111110010011110011111110010010010011111110010010010011111111110010011
110000000010000010010000000010010010000010010000000000010000000000101010110000010000010000010010010010000010010010000000011
111111110011110011110011111110010011110011111111110011110010000000101010111110010011111111110010011111110010010011111110011
110010000010010010010000000010000000000000010010000000010010000000101010110000010010010000000000010010000000000000010000011
110011111110010010011111110011111111110011110011111111111110V0V0V0101010110010011110011110010010010011111110011111110011111
110000000000000000000000000000010010000000000000000000000010000000101010110010010000010000010010000010010000010000010000011
1111111100111111111100111111100100111100111111111111111111100V0V0V101010110011110011110010010010010010011110011110011110011
110000000000010010000000010000010000000000000000010010000010000000101010110010000000000010010010010000010000000010010010011
11001111111111001111111111001001111111001001111111001001111110VV0V101010111111111111110011110011110011110011111110010010011
110000010000000000000000000010010000010010010000010000000000010000010000010010000000010010000010000010000000000000000000011
110011111111110011110010011111111110011110011110011111110010010011111111110010010011110011110011111111111111110011111111111
110010010000000000010010010010000000000000010000000000000010010010000000010000010010000010010000010010010000000000000010011
110010010010010010011111110011111111111111111111111110011110010011110011111111110010011110011110010010010011111111110010011
110010010010010010000010010000000010000000000010000010010000010000000000000000000000000000000010000010010000010000000010011
111110011110011111111110011111110010010011111110010011110011111110011110010011110011111111111111111110011110011111111110011
110000010010000000000010000010000000010010000010010010000000000010010010010010010010000010000000000010000010000010000010011
110011110010010011110010011110011111111111110010010010010011111110010010011110010011110010011111110010011110011110011110011
110000000010010010010010000000010000000000000000010010010000000010010010010000010010010000010010010000010010000010000000011
110010010010010010011110011110010011111110011111110011110011110011110010011110011110011110010010010010010010010010011111111
110010010010010000000010010000000010000000010010000000000000010000010010000000000010000000000000010010000010010000010000011
110010011111110010011111111111110011111111110010010011110011111110010010010010011111110011110010011110011110011110010011111
110010010000000010010000010000000010000010000010010010000010010000000000010010000010000010000010010010000010000010000010011
111110010011111110011110010011110011110011110010011111111110010010011110011111111110011111110011110010011110011110010010011
110010000000000010000000000010000010010000010000010000010010000010000010000000010000010000010010000000000000010010010010011
110011110010011111110011110011110010010010011111110011110010010011110011111110010010011110010011111110011111110011110010011
110000000010000000010000010010000010010010010000000000000010010010000010000010010010000010010010000000010000000010010000011
111110011110011111111111111111110010011110011110011111111111110010010011110010010010011110011111110011110010011110010011111
11001000001000001111110001000000000000000000001000000000000001001001000000001000001001000001001000000000001000001000001VV11
1100100101V0V0V11100000000000000000001001111001111001111111001001111111001111111111001111001001001001111111111001111001VV11
1100100101V0V0V11100000000000000000001000001000001000000001001000000001000001000000001001000000001000001001000001000001VV11
1100100101V0V0V11100000000000000000001001111001001111111111001001001111111001111111001001001001001001111001111001111001VV11
1100000101V0V0V11100000000000000000001000001001001001000000000001001001001001001001001000001001001001000001000001000001VV11
1111100101V0V0V1110000000000000000000111100100111100100111111100111100100111100100111100100111111111111100111111111100V0011
1100000101V0V0V1110000000000000000000000000100000100000000100100100000000000000000100000100100100000100000000000100000V0011
1111100101VVV0V1110000000000000000000100100111100111111111100111100100111100111100111100100100100111100111111111VVVV00V0011
1100100000000000100000000000000000000100100100000000000000000100000100100100100100100000100100000100000000000100VVVV00000V1
110010010010011VV00000000000000000000100111100100111111111111111100111100100100111100111100100100100111111111100VVVV00V00V1
1100000100100000000000000000000000000000100000100000000000100000000100000000000000000000100000100000000100000000000000VV0V1
111111111111111111111111111111111111111111111111111111111111111111111111111111111111111111111111111111111111111111111VVV0E1
111111111111111111111111111111111111111111111111111111111111111111111111111111111111111111111111111111111111111111111111111
